+--------------+
|11111111111111|
|11111111111111|
|11111111111111|
|11111111111111|
|11111111111111|
|11111e11111111|
|11111111111111|
|11111111111111|
|11111p11111111|
|11111111111111|
|11111111111111|
|11111111111111|
|11111111111111|
|11111111111111|
+--------------+