+__________________.                                                                                
[p1111111111111110O]                         ?______________|                                       
[111111111111111101]                        ?1111111111111111|                                      
[111111111111111101]                       ?11111111MM1MM11111|                                     
[111111111M11111101]                       [o1111111M1M1M111111|                                    
[111111111M11111101]                       [1111e111M111M1111111|                                   
[1111111M1M11111111]                       \11111111MMMMM11111111|                                  
[1111111MM111111111]                        \111111111111111111111|                                 
[100111111111111111]                         \111111111111111111111|                                
[100111111111111111]                          \1111111111111111o111]                                
[111111111111111111]                           [*111111111111111111]                                
[111111111111MMM111]                           [***1111111111111111]                                
[1O111111111MMo1M11]                           [******1111111111111]                                
<----------MM111111>                           [*********1111111111/                                
           [111111]                            [**1111111111111111/                                 
           [111111]                            [**1111111111111111|                                 
           [111111]                            [***111e111--111111O|                                
           [111111]                            [1***11111]  [1111111__________|                     
           [111111]                            [11****111]  [111111111111111111|                    
           [111111]                       ?____1111111111]  \1111111111111111111|                   
           [O111111____.                  \11111111111111]   \111111M111MMM111111|                  
           [111111111eo]                  ?11111111111111]    [11111M111M111111111|                 
           [1111111111o]                 ?O111111111111111____111111MM1oM1111111111|                
           [1111111---->                 \o111111111111111111111111111MM111111111111|               
           [111111]                       \111111111111111111111111111111111111111111|              
           [111111]                        \1111111111111O1111111111111111111111111111|             
           [111111]                         \-----111111--------111111----1111111111111|            
           [111111]                               [1111]        \MMMM/    [111111111111]            
           [111111]                               [1111]         \11/     [1O1111111111]            
           \1111111|                              [1111]          \/      [111111111111]            
            \1111111|                   +_________11111]                  [111111111111]            
             \1111111|                  [O1111111111111]                  [101111111111]            
              \1111111|                 [11111111111111/                  [10o1111e1111]            
               \1111111|                [1M11111111111/                   [100111111111]            
                \11111O1|               [oM1111111111/                    [111111111111]            
                 \11111o1|              [MM11111111O/                     [111111111111]            
                  \1111111|             [MM11111111/                      [111111111111]            
                   \1111111|            [111111111/                       [11111111111O]            
                    \1111111|           [11111111/                        \*111111111o1/            
                     \1111111|          [1111111/                          \*111111111/             
                      \1111111__________1111111/                            \*1111111/              
               +_______11111111111111111111111/                              \*11111/               
               [*1111111111111111111111111111]                                \*111/                
               [11111111111111111111111111111]                                 \11/                 
               [1e111111111111111111111111111]                                 ^^^^                 
               [11111111111111111111111111111]                                 ^^^^                 
               [111111111111O1111111111111111]                                 ^^^^                 
               [11111-----11111111111111e1111]                                 ^^^^                 
               [1111]     [11111111111111111O/                                 ^^^^                 
               [1111]     [1111111111111111*/                                  ^^^^                 
               [11111_____1111111111011111*/                                   ^^^^                 
               [Oo111111111111111111111111/                                    ^^^^                 
               <-------------------------/                                     ^^^^                 
                                                                               ^^^^                 
                                                                               ^^^^                 
                                                                               ^^^^                 
                                                                               ^^^^                 
                                                                               ^^^^                 
                                                                               ^^^^                 
                                                                               ^^^^                 
                                                                               ^^^^                 
                                                                               ^^^^                 
                                                                               ^^^^                 
                                                                               ^^^^                 
                                                                               ^^^^                 
