+___________________________________________________.                                               
[111111111111111111111111111111111111111111111111111]                                               
[11p111111111111111111111111111111111111111111111111]       +_______.                               
[111111111111111111111111111111111111111111111111111]       [1111111]                               
[11111111111111111111111MMMM111111111111111111111111]       [1111111]                               
[11111111111101111111111MMMM1111111111111111111111111_______11111111]                               
[1111111111111011111111MM1111111111111111111111111111111111111111111]                               
[11111111111111111111111M1111111111111111111111111111111111111111111]                               
[11111111111111011111111M1111111e11111111111**1111111111M11111111111]                               
[111111111111111011111111111111111111111111****111111111MM1111111111]                               
[11111111111111111011111111111111111111111******111111111MM111111111]                               
[111111111111111111001111111111111111111111****11111111111MM11111111]                               
[1111111111111111111100111111111111111111111**1111111111111MMM111111]                               
[111111111111111111111101111111111111111111111111111111111111M111111]                               
[111111110111111111111110111111111111111111111111111111111111MM11111]                               
[1111111101111111111111110001111111111111111111111111111111111MMM111]                               
[111111110011111111111111110111111111111011111110001111111111111M111]                               
[1111111111000000011111111110111111111111111100011011111111111111111]                               
[1111111111111111111111111110111111111111000011111011111111111111111]                               
[1111111111111111111111111111111111111111111111111011111111e11111111]                               
[1111111111111111111111111111111111111111101111110111111111111111111]                               
[1111111111111111111111111111111111111111110111001111111111111111111]                               
[1111111111111111111111111111111111111111111100111111111111111111111]                               
<-------------------------------111111111111111111111111111111111111]                               
                                [11111111111111111111111111111111111]                               
                                [1111111111111111------------------->                               
                                [111111111111111]                                                   
                                [111111111111111]                                                   
                                [111111111111111]                                                   
                                [111111111111111]                                                   
                                [111111111111111]                                                   
                                [111111111111111]                                                   
                                [111111111111111]                                                   
                                [11111e111111111]                                                   
                                [111111111111111]                                                   
                                [111111111111111]                                                   
                                [111111111111111]                                                   
                                [111111111111111]                                                   
                                [111111111111111]                                                   
                                [111111111111111]                                                   
                                [111111111111111]                                                   
                                [111111111111111]                                                   
                                <--------------->                   #                               
                                                                                                    
                                                                                                    
                                                                                                    
                                                                                                    
                                                                                                    
                                                                                                    
                                                                                                    
                                                                                                    
                                                                                                    
                                                                                                    
                                                                                                    
                                                                                                    
                                                                                                    
                                                                                                    
                                                                                                    
                                                                                                    
                                                                                                    
                                                                                                    
                                                                                                    
                                                                                                    
                                                                                                    
                                                                                                    
