+--------------+
|11111111111111|
|11111111111111|
|11111111111111|
|11111111111111|
|11111111111111|
|11111111111111|
|11111111111111|
|11111111111111|
|11111p11111111|
|11111111111111|
|11111111111111|
|111111e1111111|
|11111111111111|
|11111111111111|
+--------------+