     [^^^^^^^^^^^^^]     
     [1111111111111]     
_____,1111111111111L___. 
8p111111111111111111111] 
8111e1111101111111O1111L_
81111111110o11e1111111119
8111111111001111111111119
81111O1111o01111111111119
--X1111111101111111111119
  [1111e111111111*MM11119
  [1111111111111*MM*11119
  [1*1111111111MMM**11119
  [1***111111111111111x--
  [111*1111O1111111111]  
  <------------------->  
