___________________.     
8p11111e11111111111]     
8111111111111111O11]     
8111111111111111111L_____
8111111111111111111111119
8111111111111111111111119
-----X1111111111111111119
     [111M1111M1111111x--
     [11MMMMMMM1111111]  
     [11M1111M11111111]  
     [1111111111111111]  
     [11111111111111**]  
     [11111111111111*0]  
     [1111111111111o*0]  
     [7777777777777000]  
