           [^^]          
+__________,11L____.     
[11MM1111111110111O]     
[111111111111001111]     
[111MM11111100MMM11]     
[111110000000011MM1]     
[111111111111111111L_____
[11111e111111111111111119
[p111111111e1111111111119
[1111111O1111111111x-----
[111111111111111111]     
[1**111111111111111]     
[11**11111111111111]     
[O11**111111111111o]     
<------------------>     
