       [^^^]             
       [111]             
       [111L_____________
       [11111111111111119
       [11O1111MMM11O1119
+______,111111111MM111119
[p1111111111111111M111119
[1111e1111111x--X1MM11119
[11111111111O] +,11M11119
[111111111111] [111M111x-
[111111111111L_,111M111] 
[011O11111111111111M111] 
[00111111****1111111O11] 
<----------X11x--------> 
           [77]          
