 +______,^^]        [^^] 
 [O11111111]        [11] 
 [1x------->        [11] 
 [1] +______________,11] 
_,1] [11111111o11111111] 
811] [111O1111111111111] 
811] [1101111111111x---> 
811] [1100111111111]     
811] [1111111111111]     
811] [1e11111M11111]     
811] [p11111MM1111O]     
811] [111111M11111*]     
---> [11111111111**]     
     [1111111111111]     
     [7777777777777]     
