__.  [^^^^^^^^^^^^^]     
81]+_,1111111111111]     
X1][011x----------->     
[1][011L________________.
[M][0111111*****11111111]
[M][1O11e111111111111xX1]
[M][11111111111111111][1]
[M][11111111111111111][1]
[M][p1111111111111111][1]
[1][11111111111111111][1]
[1]<----------------->[1]
[1L___________________,1]
[1M1M1111111111111111111]
[OMMM111111111111111111o]
<----------------------->
