 +_____________________. 
 [MMM11M11MMM1MMMMM1M1M] 
 [M1M1M1M1M1M111M111M1M] 
 [MMM1MMM1MMM111M1111M1] 
 [M111M1M1MM1111M1111M1] 
 [M111M1M1M1M111M1111M1] 
 [11111111oOOo111111111] 
 [11   111O  O111   111] 
 [11   111O  O111   111] 
 [11   111oOOo111   111] 
 [111111111111111111111] 
 [11e1111111111111e1111] 
 [111111111111111111111] 
 [000******11*******000] 
 <---------p1----------> 
