+-------------+
|1111111111111| 
|1111111e11111|
|1111111111111| 
|1111111111111| 
|1111111111111| 
|11111e1111111| 
|1111111111111| 
|1111111111111| 
|1111111111111| 
|1111111111111| 
|1111111111111| 
|1111111111111| 
|1111111111111| 
+-------------+ 
