      +__.               
      [O1]               
      [11]        +______
______,11]  +_____,111116
8p111111*]  [101111111116
8111111**L__,10001x------
8111111**111110001]      
--------X111110001]      
        [111111101]      
        [11x----X1]      
        [11]    [1]      
        [11]    [1]      
        [11]    [1L____. 
        [11]    [111111] 
        [77]    <---X77] 
