+______.      +__________
[p11111]      [e111111119
[111MM1]      [O111111119
[1111M1]      [1111111119
[1111MM]      [1111111119
[111111]      [11111o1119
[011111]      [111x------
[001111L______,111]      
[10111111111111111]      
[11111111111111111]      
<------X111x------>      
       [111]             
       [111]             
       [111]             
       [777]             
