    +____________________
    [O1***11111****111119
    [*11111***111111**1x-
    [*1x------------X11] 
    [11]            [11] 
    [11]            [11] 
____,11] +__________,11] 
8111111] [O111111111111] 
8111111] [11e1111111111] 
----X11] [1111111111101] 
    [11] [1111111111001] 
    [11] [1111111110011] 
    [11L_,1111111110111] 
    [111M11111111111p1o] 
    <------------------> 
