[^^^^^^^^] +__________.  
[p1111111] [111e11111*]  
[1111111O] [1O11111***]  
[1M111111] [1111111111]  
[1M111111] [1111x-X111]  
[1MM11111] [1110] [11O]  
[11MMM111] [1110] [111]  
[1111MM11] [1110] [M11]  
[11111M11] [1111] [MM1]  
[11111111L_,1111] [1M1]  
[11111111111e111] [111]  
[1e1111111111111] [111L__
[111111111111111] [11O119
[O1111***111111O] [111119
<---------------> <------
