                   [^^]  
                   [11]  
                   [11]  
    +______________,11]  
    [Oo****11111111111]  
    [11p111111111e1111]  
    [*1111111111111111]  
    [*1111111xX1111111]  
    [*1e11111L,1111111]  
    [11111111111111111L__
    [111111111e1111111119
    [11111111111111111119
    [1MMMM111111111111O19
    [1111MM11111111111119
    [77777777777777777770
