    +_________________.  
    [11110111111e11111]  
    [11110011111111111]  
    [11111111111111111]  
    [111x---------X111]  
    [111]         [111]  
    [111]         [111]  
    [111]         [111]  
    [111]         [111]  
____,111]         [111]  
81p11***]         [111L__
8111***O]         [111119
-------->         [O11119
                  <X11x--
                   [77]  
