    [^^^^^^^^^^^^^^^^^^^0
    [1111111p111111111119
    [1111111111111111O119
    [11111111111111111119
+___,111e1111111111e11119
[O*1111111111111111111119
[**1111111111111111111119
[111**11111e111e111111119
[1111**1111111111111MMM19
[111****1111111111MMM1119
[e11111111e111111MMO11119
[1111*11111111111M1111119
[1111**11111111x---------
[11111*1111111O]         
<-------------->         
