+______________.         
[11111111111111]         
[11111111111111]         
[11111111111111]         
[11111111111111]         
[11111111111111]         
[11111111111111L_________
[111111111111111111111p19
[11111111111111x---------
[11111111111111]         
[11111111111111]         
[11111111111111]         
[11111111111111]         
[11111111111111]         
<-------------->         
