+__________________.     
[0111111e1111111111]     
[111111111111x--X11]     
[1x----X11111]  [*1]     
[1]    [01110]  [*1L_.   
[1L___.<X1x-->  [**1*]   
[1*11*] [1] +___,*11*]   
[*1*1*] [1] [**111***]   
<--X1*] [1] [*1******]   
   [*1] [1] [1x------>   
___,*M] [1L.[1L__________
811**M] [*o][11***111O*19
8p111M] [M*][111111***119
------> [11]<------------
        [77]             
