        [^^]             
      +_,11L_.           
      [p11111]           
      <------>           
                         
                         
  +_____________________.
  [1111111111111111**o1O]
  [1OMM111111111111****1]
__,1MMM11111111e11111111]
811MMM111e11111111111111]
811MM11111111111111e1111]
811111111111111111111111]
811111111111111111111111]
077777777777777777777777]
