0^^^^^^^^^^^^^^^^^^^^^^^]
8p1111111111111111111111]
811111111111111111111111]
8111e11111e11111e111MMMO]
8111111111111111111111MM]
81111111111111111111111M]
811111MM110O000111e1111M]
8111111M110001111111111M]
81111e111111111111111111]
81*11111111111e11111111*]
811*1111***11111111O111*]
8111*111*o111111111111**]
--------------------X1*x>
                    [11] 
                    [77] 
