   +_______________.     
   [O1111111111111O]     
   [111x-------X111]     
   [111]       [111]     
   [MM1]       [111]     
   [M11]       [***]     
___,111L_______,111L_____
8111111011O111111111O11p9
---Xe11x-------X111x-----
   [1o1]       [1M1]     
   [111]       [1MM]     
   [111]       [11M]     
   [111L_______,1O1]     
   [O11111111111111]     
   <--------------->     
