              +__________
              [O110001119
              [MM11111O19
              [1M11111119
     +________,11Mx------
     [*111e1111111]      
     [*111111111M1]      
     [*1111111MMMO]      
     [*11x-------->      
     [*11]               
     [*11]               
_____,1*1]               
8p111111*]               
8111111O*]               
--------->               
