                         
+_________________.      
[e111111111111111O]      
[11110111111111111]      
[1111011*x-----X11]      
[11100*1*]     [M1]      
,1000O***]     [M1]      
811111111]     [MM]      
X11111111]     [1M]      
[11111111]     [11L______
[11111111]     [O111111p9
[O1111111]     <---------
[11111111]               
[11111111]               
[77777777]               
