   +__________.     [^^] 
   [***1111***]     [11] 
   [*o*1111*1*]     [11] 
   [**111111**]     [p1] 
   <---X11x--->     [11] 
       [11]         [11] 
       [01]         [11] 
_______,10L_________,11] 
81111111111111111111111] 
811e1111111111111111111] 
81111111011111e11111111] 
81111111001111111111MM1] 
81111111O01111111111M1O] 
-----------------------> 
                         
