 +_____________________. 
 [MMM11M11MMM1MMMMM1M M] 
 [M M1M M1M M111M111M M] 
 [MMM1MMM1MMM1 1M1  1M1] 
 [M111M1M1MM11 1M1  1M1] 
 [M111M1M1M1M1 1M1  1M1] 
 [11111111oOOo111111111] 
 [   11111O  O11111e111] 
 [   11111O  O1   11111] 
 [11111  1oOOo1   11111] 
 [11111  111111   11e11] 
 [11e11  11111111111111] 
 [111111111111111111111] 
 [000*****e11*******000] 
 <---------p1----------> 
